Epithelial	JJ	epithelial JJ PennPOS
stem	NN	stem NN PennPOS
cell	NN	cell NN PennPOS
exhaustion	NN	exhaustion NN PennPOS
in	IN	in IN PennPOS
the	DT	the dt NUPOS
pathogenesis	NN	pathogenesis NN PennPOS
of	IN	of pp-f NUPOS
idiopathic	JJ	idiopathic JJ PennPOS
pulmonary	JJ	pulmonary JJ PennPOS
fibrosis	NN	fibrosis NN PennPOS
.	.	. . NUPOS

New	NNP	New NNP PennPOS
paradigms	NNS	paradigm NNS PennPOS
have	VBP	have vhb NUPOS
been	VBN	be vbn NUPOS
recently	RB	recent av-j NUPOS
proposed	VBN	propose VBN PennPOS
in	IN	in IN PennPOS
the	DT	the dt NUPOS
pathogenesis	NN	pathogenesis NN PennPOS
of	IN	of pp-f NUPOS
idiopathic	JJ	idiopathic JJ PennPOS
pulmonary	JJ	pulmonary JJ PennPOS
fibrosis	NN	fibrosis NN PennPOS
(	(	( ( NUPOS
IPF	NN	IPF NN PennPOS
)	)	) ) NUPOS
,	,	, , NUPOS
evidencing	VBG	evidence VBG PennPOS
that	IN	that cst NUPOS
in	IN	in IN PennPOS
IPF	NNP	IPF NN PennPOS
the	DT	the dt NUPOS
cumulative	JJ	cumulative JJ PennPOS
action	NN	action NN PennPOS
of	IN	of pp-f NUPOS
an	DT	a dt NUPOS
accelerated	VBN	accelerate VBN PennPOS
parenchymal	JJ	parenchymal JJ PennPOS
senescence	NN	senescence NN PennPOS
determined	VBN	determine VBN PennPOS
by	IN	by IN PennPOS
either	CC	either CC PennPOS
telomere	NN	telomere NN PennPOS
dysfunction	NN	dysfunction NN PennPOS
or	CC	or cc NUPOS
genetic	JJ	genetic JJ PennPOS
defects	NNS	defect NNS PennPOS
,	,	, , NUPOS
together	RB	together av NUPOS
with	IN	with pp NUPOS
the	DT	the dt NUPOS
concurrent	JJ	concurrent JJ PennPOS
noxious	JJ	noxious JJ PennPOS
activity	NN	activity NN PennPOS
of	IN	of pp-f NUPOS
tobacco	NN	tobacco NN PennPOS
smoking	NN	smoking NN PennPOS
,	,	, , NUPOS
are	VBP	be vbb NUPOS
able	JJ	able JJ PennPOS
to	TO	to p-acp NUPOS
severely	RB	severe av-j NUPOS
compromise	VB	compromise VBP PennPOS
the	DT	the dt NUPOS
regenerative	JJ	regenerative JJ PennPOS
potential	NN	potential NN PennPOS
of	IN	of pp-f NUPOS
parenchymal	JJ	parenchymal JJ PennPOS
epithelial	JJ	epithelial JJ PennPOS
stem	NN	stem NN PennPOS
cells	NNS	cell NNS PennPOS
,	,	, , NUPOS
triggering	VBG	trigger VBG PennPOS
a	DT	a dt NUPOS
cascade	NN	cascade NN PennPOS
of	IN	of pp-f NUPOS
molecular	JJ	molecular JJ PennPOS
signals	NNS	signal NNS PennPOS
and	CC	and cc NUPOS
events	NNS	event NNS PennPOS
(	(	( ( NUPOS
scarring	NN	scarring NN PennPOS
,	,	, , NUPOS
bronchiolar	JJ	bronchiolar JJ PennPOS
proliferation	NN	proliferation NN PennPOS
,	,	, , NUPOS
abnormal	JJ	abnormal JJ PennPOS
remodelling	NN	remodelling NN PennPOS
)	)	) ) NUPOS
eventually	RB	eventual av-j NUPOS
leading	VBG	lead VBG PennPOS
to	TO	to p-acp NUPOS
severe	JJ	severe JJ PennPOS
and	CC	and cc NUPOS
irreversible	JJ	irreversible JJ PennPOS
functional	JJ	functional JJ PennPOS
impairment	NN	impairment NN PennPOS
.	.	. . NUPOS

New	NNP	New NNP PennPOS
pathogenic	JJ	pathogenic JJ PennPOS
schemes	NNS	scheme NNS PennPOS
focus	VBP	focus VBP PennPOS
on	IN	on IN PennPOS
the	DT	the dt NUPOS
complex	NN	complex NN PennPOS
molecular	JJ	molecular JJ PennPOS
mechanisms	NNS	mechanism NNS PennPOS
driving	VBG	drive VBG PennPOS
in	IN	in IN PennPOS
a	DT	a dt NUPOS
vicious	JJ	vicious JJ PennPOS
circle	NN	circle NN PennPOS
the	DT	the dt NUPOS
different	JJ	different JJ PennPOS
signalling	NN	signalling NN PennPOS
pathways	NNS	pathway n2 NUPOS
(	(	( ( NUPOS
e.g.	FW	e.g. FW PennPOS
Wnt	NN	Wnt NN PennPOS
/	:	/ : NUPOS
-	:	- : NUPOS
catenin	NN	catenin NN PennPOS
,	,	, , NUPOS
TGF-beta	NN	TGF-beta NN PennPOS
,	,	, , NUPOS
caveolin-1	NN	caveolin-1 NN PennPOS
,	,	, , NUPOS
etc.	FW	etc. FW PennPOS
)	)	) ) NUPOS
potentially	RB	potential av-j NUPOS
involved	VBN	involve VBN PennPOS
in	IN	in IN PennPOS
epithelial-mesenchymal	JJ	epithelial-mesenchymal JJ PennPOS
transition	NN	transition NN PennPOS
and	CC	and cc NUPOS
irreversible	JJ	irreversible JJ PennPOS
lung	NN	lung NN PennPOS
remodelling	NN	remodelling NN PennPOS
.	.	. . NUPOS

