Medical	JJ	medical JJ PennPOS
treatment	NN	treatment NN PennPOS
for	IN	for c-acp NUPOS
pulmonary	JJ	pulmonary JJ PennPOS
fibrosis	NN	fibrosis NN PennPOS
:	:	: : NUPOS
current	JJ	current JJ PennPOS
trends	NNS	trend NNS PennPOS
,	,	, , NUPOS
concepts	NNS	concept NNS PennPOS
,	,	, , NUPOS
and	CC	and cc NUPOS
prospects	NNS	prospect n2 NUPOS
.	.	. . NUPOS

A	DT	a dt NUPOS
diagnosis	NN	diagnosis NN PennPOS
of	IN	of pp-f NUPOS
idiopathic	JJ	idiopathic JJ PennPOS
pulmonary	JJ	pulmonary JJ PennPOS
fibrosis	NN	fibrosis NN PennPOS
(	(	( ( NUPOS
IPF	NN	IPF NN PennPOS
)	)	) ) NUPOS
carries	VBZ	carry VBZ PennPOS
a	DT	a dt NUPOS
poor	JJ	poor JJ PennPOS
prognosis	NN	prognosis NN PennPOS
,	,	, , NUPOS
with	IN	with pp NUPOS
our	PRP$	our po12 NUPOS
currently	RB	current av-j NUPOS
available	JJ	available JJ PennPOS
therapies	NNS	therapy NNS PennPOS
offering	VBG	offer VBG PennPOS
little	JJ	little JJ PennPOS
clinical	JJ	clinical JJ PennPOS
benefit	NN	benefit NN PennPOS
.	.	. . NUPOS

Unfortunately	RB	unfortunate av-j NUPOS
,	,	, , NUPOS
recent	JJ	recent JJ PennPOS
major	JJ	major JJ PennPOS
advances	NNS	advance NNS PennPOS
in	IN	in IN PennPOS
our	PRP$	our po12 NUPOS
understanding	NN	understanding NN PennPOS
of	IN	of pp-f NUPOS
the	DT	the dt NUPOS
clinical	JJ	clinical JJ PennPOS
and	CC	and cc NUPOS
biologic	JJ	biologic JJ PennPOS
features	NNS	feature NNS PennPOS
of	IN	of pp-f NUPOS
this	DT	this d NUPOS
disease	NN	disease NN PennPOS
have	VBP	have vhb NUPOS
not	RB	not xx NUPOS
been	VBN	be vbn NUPOS
matched	VBN	match VBN PennPOS
by	IN	by IN PennPOS
similar	JJ	similar JJ PennPOS
advances	NNS	advance NNS PennPOS
in	IN	in IN PennPOS
treatment	NN	treatment NN PennPOS
.	.	. . NUPOS

This	DT	this d NUPOS
is	VBZ	be vbz NUPOS
likely	JJ	likely JJ PennPOS
because	IN	because c-acp NUPOS
of	IN	of pp-f NUPOS
the	DT	the dt NUPOS
complex	NN	complex NN PennPOS
cascade	NN	cascade NN PennPOS
of	IN	of pp-f NUPOS
biologic	JJ	biologic JJ PennPOS
and	CC	and cc NUPOS
pathobiologic	JJ	pathobiologic JJ PennPOS
events	NNS	event NNS PennPOS
that	WDT	that WDT PennPOS
occurs	VBZ	occur VBZ PennPOS
in	IN	in IN PennPOS
IPF	NN	IPF NN PennPOS
.	.	. . NUPOS

The	DT	the dt NUPOS
necessary	JJ	necessary JJ PennPOS
,	,	, , NUPOS
and	CC	and cc NUPOS
desperately	RB	desperate av-j NUPOS
needed	VBN	need VBN PennPOS
,	,	, , NUPOS
next	IN	next IN PennPOS
generation	NN	generation NN PennPOS
of	IN	of pp-f NUPOS
therapies	NNS	therapy NNS PennPOS
,	,	, , NUPOS
focused	VBD	focus VBD PennPOS
on	IN	on IN PennPOS
specific	JJ	specific JJ PennPOS
molecular	JJ	molecular JJ PennPOS
targets	NNS	target NNS PennPOS
thought	VBD	think VBD PennPOS
to	TO	to p-acp NUPOS
play	VB	play VBP PennPOS
pivotal	JJ	pivotal JJ PennPOS
roles	NNS	role NNS PennPOS
in	IN	in IN PennPOS
the	DT	the dt NUPOS
development	NN	development NN PennPOS
and	CC	and cc NUPOS
progression	NN	progression NN PennPOS
of	IN	of pp-f NUPOS
fibrosis	NN	fibrosis NN PennPOS
,	,	, , NUPOS
are	VBP	be vbb NUPOS
under	IN	under IN PennPOS
active	JJ	active JJ PennPOS
investigation	NN	investigation NN PennPOS
.	.	. . NUPOS

