Medical	JJ	medical O TermTag
treatment	NN	treatment O TermTag
for	IN	for O TermTag
pulmonary	JJ	pulmonary O TermTag
fibrosis	NN	fibrosis O TermTag
:	:	: : NUPOS
current	JJ	current O TermTag
trends	NNS	trend O TermTag
,	,	, , NUPOS
concepts	NNS	concept O TermTag
,	,	, , NUPOS
and	CC	and O TermTag
prospects	NNS	prospect O TermTag
.	.	. . NUPOS

A	DT	a dt NUPOS
diagnosis	NN	diagnosis O TermTag
of	IN	of O TermTag
idiopathic	JJ	idiopathic O TermTag
pulmonary	JJ	pulmonary O TermTag
fibrosis	NN	fibrosis O TermTag
(	(	( ( NUPOS
IPF	NN	IPF O TermTag
)	)	) ) NUPOS
carries	VBZ	carry O TermTag
a	DT	a dt NUPOS
poor	JJ	poor O TermTag
prognosis	NN	prognosis O TermTag
,	,	, , NUPOS
with	IN	with O TermTag
our	PRP$	our O TermTag
currently	RB	current O TermTag
available	JJ	available O TermTag
therapies	NNS	therapy O TermTag
offering	VBG	offer O TermTag
little	JJ	little O TermTag
clinical	JJ	clinical O TermTag
benefit	NN	benefit O TermTag
.	.	. . NUPOS

Unfortunately	RB	unfortunate O TermTag
,	,	, , NUPOS
recent	JJ	recent O TermTag
major	JJ	major O TermTag
advances	NNS	advance O TermTag
in	IN	in O TermTag
our	PRP$	our O TermTag
understanding	NN	understanding O TermTag
of	IN	of O TermTag
the	DT	the O TermTag
clinical	JJ	clinical O TermTag
and	CC	and O TermTag
biologic	JJ	biologic O TermTag
features	NNS	feature O TermTag
of	IN	of O TermTag
this	DT	this O TermTag
disease	NN	disease O TermTag
have	VBP	have O TermTag
not	RB	not O TermTag
been	VBN	be O TermTag
matched	VBN	match O TermTag
by	IN	by O TermTag
similar	JJ	similar O TermTag
advances	NNS	advance O TermTag
in	IN	in O TermTag
treatment	NN	treatment O TermTag
.	.	. . NUPOS

This	DT	this O TermTag
is	VBZ	be O TermTag
likely	JJ	likely O TermTag
because	IN	because O TermTag
of	IN	of O TermTag
the	DT	the O TermTag
complex	NN	complex O TermTag
cascade	NN	cascade O TermTag
of	IN	of O TermTag
biologic	JJ	biologic O TermTag
and	CC	and O TermTag
pathobiologic	JJ	pathobiologic O TermTag
events	NNS	event O TermTag
that	WDT	that O TermTag
occurs	VBZ	occur O TermTag
in	IN	in O TermTag
IPF	NN	IPF O TermTag
.	.	. . NUPOS

The	DT	the O TermTag
necessary	JJ	necessary O TermTag
,	,	, , NUPOS
and	CC	and O TermTag
desperately	RB	desperate O TermTag
needed	VBN	need O TermTag
,	,	, , NUPOS
next	IN	next O TermTag
generation	NN	generation O TermTag
of	IN	of O TermTag
therapies	NNS	therapy O TermTag
,	,	, , NUPOS
focused	VBD	focus O TermTag
on	IN	on O TermTag
specific	JJ	specific O TermTag
molecular	JJ	molecular O TermTag
targets	NNS	target O TermTag
thought	VBD	think O TermTag
to	TO	to O TermTag
play	VB	play O TermTag
pivotal	JJ	pivotal O TermTag
roles	NNS	role O TermTag
in	IN	in O TermTag
the	DT	the O TermTag
development	NN	development O TermTag
and	CC	and O TermTag
progression	NN	progression O TermTag
of	IN	of O TermTag
fibrosis	NN	fibrosis O TermTag
,	,	, , NUPOS
are	VBP	be O TermTag
under	IN	under O TermTag
active	JJ	active O TermTag
investigation	NN	investigation O TermTag
.	.	. . NUPOS

