Epithelial	JJ
stem	NN
cell	NN
exhaustion	NN
in	IN
the	DT
pathogenesis	NN
of	IN
idiopathic	JJ
pulmonary	JJ
fibrosis	NN
.	.

New	NNP
paradigms	NNS
have	VBP
been	VBN
recently	RB
proposed	VBN
in	IN
the	DT
pathogenesis	NN
of	IN
idiopathic	JJ
pulmonary	JJ
fibrosis	NN
(	(
IPF	NN
)	)
,	,
evidencing	VBG
that	IN
in	IN
IPF	NNP
the	DT
cumulative	JJ
action	NN
of	IN
an	DT
accelerated	VBN
parenchymal	JJ
senescence	NN
determined	VBN
by	IN
either	CC
telomere	NN
dysfunction	NN
or	CC
genetic	JJ
defects	NNS
,	,
together	RB
with	IN
the	DT
concurrent	JJ
noxious	JJ
activity	NN
of	IN
tobacco	NN
smoking	NN
,	,
are	VBP
able	JJ
to	TO
severely	RB
compromise	VB
the	DT
regenerative	JJ
potential	NN
of	IN
parenchymal	JJ
epithelial	JJ
stem	NN
cells	NNS
,	,
triggering	VBG
a	DT
cascade	NN
of	IN
molecular	JJ
signals	NNS
and	CC
events	NNS
(	(
scarring	NN
,	,
bronchiolar	JJ
proliferation	NN
,	,
abnormal	JJ
remodelling	NN
)	)
eventually	RB
leading	VBG
to	TO
severe	JJ
and	CC
irreversible	JJ
functional	JJ
impairment	NN
.	.

New	NNP
pathogenic	JJ
schemes	NNS
focus	VBP
on	IN
the	DT
complex	NN
molecular	JJ
mechanisms	NNS
driving	VBG
in	IN
a	DT
vicious	JJ
circle	NN
the	DT
different	JJ
signalling	NN
pathways	NNS
(	(
e.g.	FW
Wnt	NN
/	:
-	:
catenin	NN
,	,
TGF-beta	NN
,	,
caveolin-1	NN
,	,
etc.	FW
)	)
potentially	RB
involved	VBN
in	IN
epithelial-mesenchymal	JJ
transition	NN
and	CC
irreversible	JJ
lung	NN
remodelling	NN
.	.

