Epithelial	JJ	epithelial O TermTag
stem	NN	stem O TermTag
cell	NN	cell O TermTag
exhaustion	NN	exhaustion O TermTag
in	IN	in O TermTag
the	DT	the O TermTag
pathogenesis	NN	pathogenesis O TermTag
of	IN	of O TermTag
idiopathic	JJ	idiopathic O TermTag
pulmonary	JJ	pulmonary O TermTag
fibrosis	NN	fibrosis O TermTag
.	.	. . NUPOS

New	NNP	New O TermTag
paradigms	NNS	paradigm O TermTag
have	VBP	have O TermTag
been	VBN	be O TermTag
recently	RB	recent O TermTag
proposed	VBN	propose O TermTag
in	IN	in O TermTag
the	DT	the O TermTag
pathogenesis	NN	pathogenesis O TermTag
of	IN	of O TermTag
idiopathic	JJ	idiopathic O TermTag
pulmonary	JJ	pulmonary O TermTag
fibrosis	NN	fibrosis O TermTag
(	(	( ( NUPOS
IPF	NN	IPF O TermTag
)	)	) ) NUPOS
,	,	, , NUPOS
evidencing	VBG	evidence O TermTag
that	IN	that O TermTag
in	IN	in O TermTag
IPF	NNP	IPF O TermTag
the	DT	the O TermTag
cumulative	JJ	cumulative O TermTag
action	NN	action O TermTag
of	IN	of O TermTag
an	DT	a O TermTag
accelerated	VBN	accelerate O TermTag
parenchymal	JJ	parenchymal O TermTag
senescence	NN	senescence O TermTag
determined	VBN	determine O TermTag
by	IN	by O TermTag
either	CC	either O TermTag
telomere	NN	telomere O TermTag
dysfunction	NN	dysfunction O TermTag
or	CC	or O TermTag
genetic	JJ	genetic O TermTag
defects	NNS	defect O TermTag
,	,	, , NUPOS
together	RB	together O TermTag
with	IN	with O TermTag
the	DT	the O TermTag
concurrent	JJ	concurrent O TermTag
noxious	JJ	noxious O TermTag
activity	NN	activity O TermTag
of	IN	of O TermTag
tobacco	NN	tobacco O TermTag
smoking	NN	smoking O TermTag
,	,	, , NUPOS
are	VBP	be O TermTag
able	JJ	able O TermTag
to	TO	to O TermTag
severely	RB	severe O TermTag
compromise	VB	compromise O TermTag
the	DT	the O TermTag
regenerative	JJ	regenerative O TermTag
potential	NN	potential O TermTag
of	IN	of O TermTag
parenchymal	JJ	parenchymal O TermTag
epithelial	JJ	epithelial O TermTag
stem	NN	stem O TermTag
cells	NNS	cell O TermTag
,	,	, , NUPOS
triggering	VBG	trigger O TermTag
a	DT	a dt NUPOS
cascade	NN	cascade O TermTag
of	IN	of O TermTag
molecular	JJ	molecular O TermTag
signals	NNS	signal O TermTag
and	CC	and O TermTag
events	NNS	event O TermTag
(	(	( ( NUPOS
scarring	NN	scarring O TermTag
,	,	, , NUPOS
bronchiolar	JJ	bronchiolar O TermTag
proliferation	NN	proliferation O TermTag
,	,	, , NUPOS
abnormal	JJ	abnormal O TermTag
remodelling	NN	remodelling O TermTag
)	)	) ) NUPOS
eventually	RB	eventual O TermTag
leading	VBG	lead O TermTag
to	TO	to O TermTag
severe	JJ	severe O TermTag
and	CC	and O TermTag
irreversible	JJ	irreversible O TermTag
functional	JJ	functional O TermTag
impairment	NN	impairment O TermTag
.	.	. . NUPOS

New	NNP	New O TermTag
pathogenic	JJ	pathogenic O TermTag
schemes	NNS	scheme O TermTag
focus	VBP	focus O TermTag
on	IN	on O TermTag
the	DT	the O TermTag
complex	NN	complex O TermTag
molecular	JJ	molecular O TermTag
mechanisms	NNS	mechanism O TermTag
driving	VBG	drive O TermTag
in	IN	in O TermTag
a	DT	a dt NUPOS
vicious	JJ	vicious O TermTag
circle	NN	circle O TermTag
the	DT	the O TermTag
different	JJ	different O TermTag
signalling	NN	signalling O TermTag
pathways	NNS	pathway O TermTag
(	(	( ( NUPOS
e.g.	FW	e.g. O TermTag
Wnt	NN	Wnt O TermTag
/	:	/ : NUPOS
-	:	- : NUPOS
catenin	NN	catenin O TermTag
,	,	, , NUPOS
TGF-beta	NN	TGF-beta GENE TermTag
,	,	, , NUPOS
caveolin-1	NN	caveolin-1 GENE TermTag
,	,	, , NUPOS
etc.	FW	etc. O TermTag
)	)	) ) NUPOS
potentially	RB	potential O TermTag
involved	VBN	involve O TermTag
in	IN	in O TermTag
epithelial-mesenchymal	JJ	epithelial-mesenchymal O TermTag
transition	NN	transition O TermTag
and	CC	and O TermTag
irreversible	JJ	irreversible O TermTag
lung	NN	lung O TermTag
remodelling	NN	remodelling O TermTag
.	.	. . NUPOS

